30 30
******************************
*************-****************
************-*****************   
***********-******************   
**********-*******************
*********-********************
********-*********************   
*******-**********************   
******-***********************
*****-************************
****-*************************
***-**************************
**-***************************
*-****************************
******************************
******************************
******************************
******************************
******************************
******************************   
******************************   
******************************
******************************
*****************------------*   
*#***************-********$-**   
*-----------------**--------**
********************------****
*************************-****
------------------------*-****
******************************