30 30
******************************
******************************
******************************   
******************************   
******************************
******************************
******************************   
******************************   
*****----**********-----******
*****----**********-----******
*****----**********-----******
*****----**********-----******
*****---------*---------******
*****--------***--------******
*****-------*****-------******
*****------*******------******
*****-----*********-----******
*****----**********$----******
*****-------------------******
*****----#**********----******
*****-----*********-----******
*****------*******------******
*****-------*****-------******
*****--------***--------******   
*****---------*---------******   
*****----***********----******
******************************
******************************
******************************
******************************