30 30
******************************
**************#***************
********--------------********   
********--------------********   
********--------------********
********--------------********
********--------------********   
********--------------********   
********--------------********
******************************
--------*--********--*--------
****--*-*--*------*--*-*---***
****--*-*--*------*--*-*---***
*******-*--*------*--*-*---***
****--*-*--*------*--*-*---***
****--*-*--*------*--*-*******
****--*-*--********--*-*---***
****--***---------*--***---***
****-----------------------***
****----***************----***   
****----***************----***   
****----***************----***
****----******$********----***
****----***************----***   
****----***************----***   
****----***************----***
****----***************----***
******************************
******************************
******************************