30 30
******************************
*************-****************
************-****-------------   
***********-******************   
**********-****---------------
*********-********************
********-**-------------------   
*******-**********************   
******-***--------------------
*****-************************
****-***----------------------
***-**************************
*#-***------------------------
*-****************************
****--------------------------
******************************
**----------------------------
******************************
******************************
******************************   
******************************   
******************************
******************************
*****************------------*   
*****************-********$-**   
*-----------------**--------**
********************------****
*************************-****
------------------------*-****
******************************