29 26
**#***********************
*----*-----*--*-----*----*
*----*-----*--*-----*----*   
*----*-----*--*-----*----*   
**************************
-----*--*--------*--*----*
-----*--*--------*--*----*
******--****--****--******
-----*-----*--*-----*-----
-----*-----*--*-----*-----
-----*--**********--*-----
-----*--*--------*--*-----
-----*--*--------*--*-----
*********--------*********
-----*--*--------*--*-----
-----*--*--------*--*-----
-----*--**********--*-----
-----*--*--------*--*-----
-----*--*--------*--*-----
************--************
*----*-----*--*-----*----*
*----*-----*--*-----*----*
***--****************--***
--*--*--*--------*--*--*--
--*--*--*--------*--*--*--
******--****--****--******
*----------*--*----------*
*----------*--*----------*
**********************$***
