8 30
******************************
******************************
******************************   
***********$#*****************   
******************************
******************************
******************************   
******************************   
