29 40
************--**************************
*----*-----*--*-----*----***************
*----*-----*--*-----*----***************
*----*-----*--*-----*----***************
****************************************
-----*--*--------*--*----***************
-----*--*--------*--*----***************
******--****--****--********************
-----*-----*--*-----*-----**************
-----*-----*--*-----*-----**************
-----*--**********--*-----**************
-----*--*--------*--*-----**************
-----*--*--------*--*-----**************
*********--------***********************
-----*--*--------*--*-----**************
-----*--*--------*--*-----**************
-----*--***#******--*-----**************
-----*--*--------*--*-----**************
-----*--*--------*--*-----**************
************--**************************
*----*-----*--*-----*----********$******
*----*-----*--*-----*----***************
***--****************--*****************
--*--*--*--------*--*--*--**************
--*--*--*--------*--*--*--**************
******--****--****--********************
*----------*--*----------***************
*----------*--*----------***************
****************************************
